NO ./textures/north.xpm
SO ./textures/south.xpm






F 222,			252,+++249
WE ./textures/west.xpm
EA ./textures/east.xpm

C 204,      1 68        ,+2    33

  1111111
1100111
1000011
100S001
1000001
1111111