NO ./textures/1.xpm
SO ./textures/2.xpm






F 222,252,249
WE ./textures/4.xpm
EA ./textures/3.xpm

C 204,168,233
EA ./textures/2.xpm

  1111111
1100111
1000011
100S001
1000001
1111111