NO ./textures/1.xpm
SO ./textures/2.xpm

EA ./textures/4.xpm

F 222,252,249
C 204,168,233

WE ./textures/3.xpm

1111111
1000111
1000011
100S001
1000001
1111111