NO ./textures/north.xpm
SO ./textures/south.xpm






F 222,			252,+++249
WE ./textures/west.xpm     
EA 		    ./textures/east.xpm

C 204,      1 68        ,+2    33

  1111111
1100111
1001011
100S101
1001011
1111111