NO ./textures/north.xpm
SO ./textures/south.xpm






F 222,			252,+++249
WE ./textures/west.xpm     
EA 		  ./textures/east.xpm

C 204,    1 68  , 2    33

    11111111
   11001111
11111101S001111
1001101111000011
1111111111111111